11 7 7 7 7 12 7 7 7 7 7 10
4 1 1 1 0 0 0 0 1 1 1 3
4 1 5 5 5 5 5 5 5 5 1 3
4 1 5 5 5 5 5 5 5 5 1 3
4 1 5 5 5 5 5 5 5 5 1 3
4 1 1 1 1 1 1 1 1 1 1 3
9 6 6 6 6 6 6 6 6 6 6 8