9 5 5 5 5 10 5 5 5 5 5 8
2 0 0 0 0 0 0 0 0 0 0 3
2 0 1 1 1 1 1 1 1 1 0 3
2 0 1 1 1 1 1 1 1 1 0 3
2 0 1 1 1 1 1 1 1 1 0 3
2 0 0 0 0 0 0 0 0 0 0 3
7 4 4 4 4 4 4 4 4 4 4 6